map=[
6,6,6,6,6,6,4,4,4,4,4,6,6,4,4,4,4,4,4,4,4,4,4,4,4,4,4,4,4,4,4,4,4,4,4,4,4,4,4,4,4,4,4,4,4,4,4,4,4,4,4,4,4,4,4,4,4,4,4,4,4,4,4,4,4,4,4,4,4,4,4,4,4,4,4,4,4,4,4,4,4,4,4,4,4,4,4,4,4,4,4,4,4,4,4,7,7,7,7,7,
6,6,6,6,6,4,4,4,4,6,6,6,6,4,4,4,4,4,4,4,4,4,4,4,4,4,4,4,4,4,4,4,4,4,4,4,4,4,4,4,4,4,4,4,4,4,4,4,4,4,4,4,4,4,4,4,4,4,4,4,4,4,4,4,4,4,4,4,4,4,4,4,4,4,4,4,4,4,4,4,4,4,4,4,4,4,4,4,4,4,4,4,4,4,4,7,7,7,7,7,
6,6,6,6,6,6,4,4,4,4,6,6,6,6,4,4,4,4,4,4,4,4,4,4,4,4,4,4,4,4,4,4,4,4,4,4,4,4,4,4,4,4,4,4,4,4,4,4,4,4,4,4,4,4,4,4,4,4,4,4,4,4,4,4,4,4,4,4,4,4,4,4,4,4,4,4,4,4,4,4,4,4,4,4,4,4,4,4,4,4,4,4,4,4,7,7,7,7,7,7,
6,6,6,6,4,4,4,4,4,6,6,6,6,4,4,4,4,4,4,4,4,4,4,4,4,4,4,4,4,4,4,4,4,4,4,4,4,4,4,4,4,4,4,4,4,4,4,4,4,4,4,4,4,4,4,4,4,4,4,4,4,4,4,4,4,4,4,4,4,4,4,4,4,4,4,4,4,4,4,4,4,4,4,4,4,4,4,4,4,4,4,4,4,4,7,7,7,7,7,7,
6,6,6,6,6,4,6,4,4,4,4,6,4,4,4,4,4,4,4,4,4,4,4,4,4,4,4,4,4,4,4,4,4,4,4,4,4,4,4,4,4,4,4,4,4,4,4,4,4,4,4,4,4,4,4,4,4,4,4,4,4,4,4,4,4,4,4,4,4,4,4,4,4,4,4,4,4,4,4,4,4,4,4,4,4,4,4,4,4,4,4,4,4,7,7,7,7,7,7,7,
6,6,6,6,6,6,6,4,4,4,4,4,4,4,4,4,4,4,4,4,4,4,4,4,4,4,4,4,4,4,4,4,4,4,4,4,4,4,4,4,4,4,4,4,4,4,4,4,4,4,4,4,4,4,4,4,4,4,4,4,4,4,4,4,4,4,4,4,4,4,4,4,4,4,4,4,4,4,4,4,4,4,4,4,4,4,4,4,4,4,4,4,4,7,7,7,7,7,7,7,
6,6,6,6,6,6,6,6,4,4,6,4,4,4,4,4,4,4,4,4,4,4,4,4,4,4,4,4,4,4,4,4,4,4,4,4,4,4,4,4,4,4,4,4,4,4,4,4,2,4,4,4,4,4,4,4,4,4,4,4,4,4,4,4,4,4,4,4,4,4,4,4,4,4,4,4,4,4,4,4,4,4,4,4,4,4,4,4,4,4,4,4,4,4,7,7,7,7,7,7,
6,6,6,6,6,6,6,4,6,6,6,4,4,4,4,4,4,4,4,4,4,4,4,4,4,4,4,4,4,4,4,4,4,4,4,2,4,4,4,4,4,4,4,4,4,4,4,4,2,2,4,4,2,4,4,4,4,4,4,4,4,4,4,4,4,4,4,4,2,4,2,2,4,4,4,4,4,4,4,1,2,4,4,4,4,4,4,4,4,4,4,4,7,7,7,7,7,7,7,7,
6,6,6,6,6,6,6,4,4,6,6,6,6,4,4,4,4,4,4,4,4,4,4,4,2,2,2,2,2,1,5,1,1,4,4,4,2,1,2,2,1,1,4,4,4,2,2,2,2,2,2,2,2,2,2,4,4,4,2,4,4,1,1,4,4,4,4,2,4,2,2,2,2,2,4,4,4,4,4,1,2,2,2,4,4,4,1,4,4,4,2,2,7,7,7,7,7,7,7,7,
6,6,6,6,6,6,4,4,4,6,6,6,6,4,4,4,4,4,4,4,4,4,2,2,2,1,1,1,5,5,5,5,1,2,3,3,1,1,5,5,5,1,1,1,2,2,2,2,2,2,2,2,2,2,2,3,3,2,2,1,1,1,1,1,1,1,2,2,2,2,2,2,2,2,2,1,1,1,1,2,2,2,2,1,1,1,1,2,2,2,2,2,7,7,7,7,7,7,7,7,
6,6,6,6,6,6,6,4,4,4,6,6,6,4,4,4,4,4,4,4,4,4,2,1,5,5,5,5,5,5,5,5,1,1,3,3,3,1,5,5,5,5,5,5,1,2,2,2,1,1,2,2,2,2,2,3,3,3,2,2,2,1,1,1,1,1,2,2,2,2,2,2,2,2,1,1,1,1,5,1,5,5,5,5,5,1,1,1,3,3,2,7,7,7,7,7,7,7,7,7,
6,6,6,6,6,6,4,4,4,6,6,6,4,4,4,4,4,4,4,2,4,2,1,5,5,5,5,5,5,5,5,5,1,2,3,3,1,1,5,5,5,5,5,5,3,3,2,1,1,2,2,2,2,2,2,3,3,2,2,2,2,1,1,1,2,3,3,2,2,2,2,2,2,2,5,1,5,5,5,5,5,5,5,5,5,1,5,3,3,3,2,7,7,7,7,7,7,7,7,7,
6,6,6,6,6,6,6,6,4,4,6,4,4,4,4,4,4,4,4,2,1,2,5,5,5,5,5,5,5,5,5,5,5,5,5,2,1,5,5,5,5,5,5,5,3,3,3,1,5,1,2,2,2,2,2,2,2,2,2,2,2,2,1,1,1,3,3,3,2,2,2,2,2,2,1,5,3,3,1,5,5,5,5,5,5,2,5,5,3,3,7,7,7,7,7,7,7,7,7,7,
6,6,6,6,6,6,6,4,4,4,4,4,4,4,4,4,4,2,1,1,5,5,5,5,5,5,5,5,5,5,5,5,5,1,1,5,5,5,5,5,5,5,5,5,3,3,5,5,1,2,2,2,2,2,2,2,2,2,2,2,2,1,1,1,1,3,3,2,2,2,2,2,2,2,1,3,3,3,5,5,5,5,5,2,2,5,5,1,2,7,7,7,7,7,7,7,7,7,7,7,
6,6,6,6,6,6,6,4,4,4,4,4,4,4,4,4,2,2,1,1,5,5,5,5,5,5,5,2,5,5,5,5,5,5,1,5,5,5,5,5,5,5,5,5,5,5,2,5,5,2,2,2,2,2,2,2,2,2,2,2,2,2,1,1,1,2,2,2,2,2,2,2,2,2,5,5,3,3,5,5,5,5,5,5,5,5,5,5,7,7,7,7,7,7,7,7,7,7,7,7,
6,6,6,6,6,6,4,4,4,4,4,4,4,4,4,4,1,1,1,5,5,5,5,5,5,5,5,2,2,5,5,1,1,1,5,5,5,2,5,5,5,5,5,5,2,2,5,1,2,2,2,2,2,1,2,2,2,2,2,2,2,2,1,2,1,2,2,2,2,2,2,2,2,1,5,5,5,1,5,5,5,5,5,5,5,5,5,5,7,7,7,7,7,7,7,7,7,7,7,7,
6,6,6,6,6,6,6,4,4,4,4,4,4,4,4,4,2,1,5,5,5,5,5,5,5,5,5,5,5,2,5,1,1,1,1,1,5,5,2,5,5,5,1,2,2,2,2,2,2,2,2,1,1,1,1,2,2,2,2,2,2,2,2,2,2,2,2,2,2,2,2,2,2,5,5,5,5,5,2,5,5,5,5,5,5,5,5,5,7,7,7,7,7,7,7,7,7,7,7,7,
6,6,6,6,6,6,6,4,4,4,4,4,4,4,4,2,1,5,5,5,5,5,5,5,5,5,5,5,5,1,1,1,1,1,1,1,1,1,1,1,1,1,1,2,2,2,2,2,2,2,2,1,1,1,1,2,2,2,2,2,2,2,2,2,2,2,2,2,2,2,2,2,1,5,5,5,5,5,2,5,5,5,5,5,5,5,5,5,5,7,7,7,7,7,7,7,7,7,7,7,
6,6,6,6,6,6,4,4,4,4,4,4,4,4,4,2,1,1,5,5,5,5,5,5,5,5,5,5,5,1,1,1,1,1,1,1,1,1,1,1,1,1,1,1,2,2,2,2,2,2,2,1,1,1,1,2,2,2,2,2,2,2,2,2,2,2,2,2,2,2,2,2,1,5,5,5,5,5,5,2,5,5,5,5,5,5,5,5,5,7,7,7,7,7,7,7,7,7,7,7,
6,6,6,6,6,6,4,4,4,4,4,4,4,4,4,2,1,5,5,5,5,5,5,5,5,5,5,5,5,1,1,1,1,1,1,1,1,1,1,1,1,1,1,2,2,2,2,2,2,2,2,2,1,2,1,2,2,2,2,2,2,2,2,2,2,2,2,2,2,2,2,2,1,1,2,5,5,5,1,5,5,5,5,5,5,5,5,5,7,7,7,7,7,7,7,7,7,7,7,7,
6,6,6,6,6,6,6,4,4,4,4,4,4,4,4,4,2,5,5,5,5,5,5,5,5,5,5,5,5,1,1,1,1,1,1,1,1,1,1,1,1,1,1,1,2,2,2,2,2,2,2,2,3,3,2,2,2,2,2,2,2,2,2,2,2,2,2,2,2,2,2,2,1,5,5,2,5,5,5,1,5,5,5,5,5,5,5,5,5,7,7,7,7,7,7,7,7,7,7,7,
6,6,6,6,6,6,4,4,4,4,4,4,4,4,4,4,1,5,5,1,5,1,5,5,5,5,5,5,5,1,1,1,1,1,1,1,1,1,1,1,1,1,1,3,3,2,2,2,2,2,2,3,3,3,2,2,5,5,2,2,2,2,2,2,2,2,2,2,2,2,2,1,1,1,5,5,5,5,1,5,5,5,5,5,5,5,7,7,7,5,7,7,7,7,7,7,7,7,7,7,
6,6,6,6,6,6,4,4,4,4,4,4,4,4,4,2,2,5,5,2,3,3,1,5,5,5,5,1,1,1,1,1,2,1,1,1,1,1,1,1,1,1,1,3,3,3,2,2,2,2,2,2,3,3,2,2,2,5,5,5,1,2,2,2,2,2,2,2,2,2,2,2,1,1,1,1,5,3,3,5,5,5,5,5,5,5,2,5,5,5,7,7,7,7,7,7,7,7,7,7,
6,6,6,6,6,6,6,4,4,4,4,4,4,4,4,2,2,5,2,3,3,3,2,1,1,5,5,5,1,1,2,2,2,3,3,1,1,1,1,1,1,1,1,3,3,2,2,2,2,2,2,2,2,2,2,2,5,5,5,1,3,3,2,2,2,2,2,2,2,2,2,2,1,1,1,1,3,3,3,1,5,5,5,5,1,2,5,5,5,5,7,7,7,7,7,7,7,7,7,7,
6,6,6,6,6,6,6,4,4,4,4,4,4,4,4,2,5,2,2,2,3,3,2,1,5,1,1,5,1,1,1,2,2,3,3,3,1,1,1,1,1,1,1,1,2,2,2,2,2,2,2,2,2,2,2,2,2,5,5,5,3,3,3,2,2,2,2,2,2,2,2,2,1,1,1,1,1,3,3,5,5,5,5,1,1,5,5,5,5,7,7,7,7,7,7,7,7,7,7,7,
6,6,6,4,4,6,6,4,4,4,4,4,4,4,4,1,5,5,5,5,1,2,5,5,5,5,1,1,1,1,1,1,2,3,3,1,1,1,1,1,1,1,1,1,2,2,2,2,2,2,2,2,2,2,5,2,5,5,5,1,3,3,2,2,2,2,2,2,2,2,2,1,1,1,1,1,1,1,1,1,5,3,3,5,5,5,5,5,7,7,7,7,7,7,7,7,7,7,7,7,
6,6,6,4,4,4,6,4,4,4,4,4,4,4,4,2,1,5,5,5,5,5,1,5,5,5,5,5,1,1,1,1,1,1,1,1,1,1,1,1,1,1,1,1,2,2,2,2,2,2,2,2,2,2,2,5,1,5,5,5,5,1,2,2,2,2,2,2,2,2,2,2,2,1,1,1,1,1,1,1,5,3,3,3,5,5,5,5,7,7,7,7,7,7,7,7,7,7,7,7,
6,6,6,4,4,4,4,4,4,4,4,4,4,4,2,1,5,5,5,5,5,1,5,5,5,5,5,1,1,1,1,1,1,1,1,1,1,1,1,1,1,1,1,2,2,2,2,2,2,2,2,2,2,2,5,5,2,2,5,5,1,2,2,2,2,2,2,2,2,2,2,2,1,1,1,1,1,1,1,1,1,3,3,5,5,5,5,7,7,7,7,7,7,7,7,7,7,7,7,7,
6,6,6,6,6,6,4,4,4,4,4,4,4,4,4,4,1,5,5,5,5,5,2,5,5,5,5,2,1,1,1,1,1,1,1,1,1,1,1,1,1,1,1,1,1,2,2,2,2,2,2,2,2,2,2,1,5,5,2,2,2,2,2,2,2,2,2,2,2,2,2,2,1,1,1,1,1,1,1,1,5,5,1,5,5,5,5,7,7,7,7,7,7,7,7,7,7,7,7,7,
6,6,6,6,6,4,4,4,4,4,4,4,4,4,4,1,1,5,5,5,5,5,2,2,5,5,5,2,1,1,1,1,1,1,1,1,1,1,1,1,1,1,1,1,1,2,2,2,2,2,2,2,2,1,1,1,5,5,5,5,2,2,2,2,2,2,1,2,2,2,2,2,1,1,1,1,1,1,5,5,5,5,5,5,5,5,7,7,7,7,7,7,7,7,7,7,7,7,7,7,
6,6,6,6,6,6,4,6,4,4,4,4,4,4,4,4,2,5,5,5,5,5,5,5,1,5,2,1,1,1,1,1,1,1,1,1,1,1,1,1,1,1,1,1,1,2,2,2,2,2,2,2,1,1,1,1,1,5,2,5,2,2,2,2,2,2,2,1,1,3,3,2,1,1,1,1,1,1,5,5,5,5,5,5,5,5,7,7,7,7,7,7,7,7,7,7,7,7,7,7,
6,6,6,6,6,4,6,6,6,4,4,4,4,4,4,4,2,1,5,5,5,5,5,1,1,1,1,1,1,1,1,1,1,1,1,1,1,1,1,1,1,1,1,1,1,2,2,2,2,2,2,2,1,1,1,1,1,2,2,2,3,3,2,2,2,2,1,1,3,3,3,1,1,1,1,1,1,5,5,5,5,5,5,5,5,7,7,7,7,7,7,7,7,7,7,7,7,7,7,7,
6,6,6,6,6,6,4,6,6,6,4,4,4,4,4,4,2,4,1,1,5,5,5,5,5,5,3,3,1,1,1,1,1,1,1,1,1,1,1,1,1,1,1,1,2,2,2,2,3,3,2,2,1,1,1,1,1,2,2,2,3,3,3,2,2,2,1,1,1,3,3,2,1,1,1,1,1,5,5,5,5,5,5,5,5,5,7,7,7,7,7,7,7,7,7,7,7,7,7,7,
6,6,6,6,6,4,6,6,4,4,4,4,4,4,4,4,4,4,4,4,5,1,5,5,5,3,3,3,1,1,1,1,1,1,1,1,1,2,3,3,1,1,1,1,2,2,2,3,3,3,2,2,2,2,1,2,2,2,2,2,3,3,2,2,2,2,2,1,1,2,2,1,1,1,1,1,1,5,5,5,5,5,5,5,5,7,7,7,7,7,7,7,7,7,7,7,7,7,7,7,
6,6,6,6,6,6,4,4,4,4,4,4,4,4,4,4,4,4,4,4,4,4,1,1,5,5,3,3,1,1,1,1,1,1,1,1,1,2,3,3,3,1,1,1,2,2,2,2,3,3,2,2,2,2,1,1,2,2,2,2,2,2,2,2,2,2,2,1,1,2,2,1,1,1,1,1,1,5,5,5,2,2,7,5,5,7,7,7,7,7,7,7,7,7,7,7,7,7,7,7,
6,6,6,6,6,6,6,4,4,4,4,4,4,4,4,4,4,4,4,4,4,4,4,1,1,2,2,2,1,1,1,1,1,1,1,1,1,1,3,3,1,1,1,1,2,2,2,2,2,2,2,2,2,2,2,2,2,2,2,2,2,2,2,2,2,2,2,2,2,2,2,2,1,3,3,1,5,5,1,1,5,5,7,5,7,7,7,7,7,7,7,7,7,7,7,7,7,7,7,7,
6,6,6,6,6,6,4,4,4,4,4,4,4,4,4,4,4,4,4,4,4,4,4,4,4,4,4,4,1,1,1,1,1,1,1,1,1,1,1,2,1,1,1,1,2,2,2,2,2,2,2,2,2,2,2,2,2,2,2,2,2,2,2,2,2,2,2,2,2,2,2,2,1,3,3,3,1,1,1,5,5,5,5,7,7,7,7,7,7,7,7,7,7,7,7,7,7,7,7,7,
6,6,6,6,6,4,4,4,4,4,4,4,4,4,4,4,4,4,4,4,4,4,4,4,4,4,4,1,1,1,1,1,1,1,1,1,1,1,1,1,1,1,2,2,2,2,2,2,2,2,2,2,2,2,2,2,2,2,2,2,2,2,2,2,2,2,2,2,2,2,2,2,1,3,3,5,5,5,5,5,5,5,7,7,7,7,7,7,7,7,7,7,7,7,7,7,7,7,7,7,
6,6,6,6,6,6,4,6,4,4,4,4,4,4,4,4,4,4,4,4,4,4,4,4,4,4,4,4,4,4,1,1,1,1,1,1,1,1,1,1,1,1,1,2,2,2,2,2,2,2,2,2,2,2,2,2,2,2,2,2,2,2,2,2,2,2,2,2,2,2,2,2,1,1,5,5,5,5,5,5,5,5,5,5,7,7,7,7,7,7,7,7,7,7,7,7,7,7,7,7,
6,6,6,6,6,6,6,4,4,4,4,4,4,4,4,4,4,4,4,4,4,4,4,4,4,4,4,4,4,4,4,4,4,1,1,1,1,1,1,1,1,2,2,2,2,2,2,2,2,2,2,2,2,2,2,2,2,2,2,2,2,2,2,2,2,2,2,2,2,2,2,1,1,1,5,5,5,5,5,5,5,5,5,7,7,7,7,7,7,7,7,7,7,7,7,7,7,7,7,7,
6,6,6,6,6,6,6,4,4,4,4,4,4,4,4,4,4,4,4,4,4,4,4,4,4,4,4,4,4,4,4,4,4,4,4,1,1,1,1,1,2,2,2,2,2,2,2,2,2,2,2,2,2,2,2,2,2,2,2,2,2,2,2,3,3,2,2,2,2,2,2,5,5,1,5,5,5,5,5,5,5,5,5,7,7,7,7,7,7,7,7,7,7,7,7,7,7,7,7,7,
6,6,6,6,6,6,6,4,4,4,4,4,4,4,4,4,4,4,4,4,4,4,4,4,4,4,4,4,4,4,4,4,4,4,4,4,4,4,4,1,2,2,2,2,2,1,2,1,2,1,2,2,2,2,2,2,2,2,2,2,2,2,3,3,3,2,2,2,2,5,2,5,5,5,5,5,5,5,5,5,5,5,5,7,7,7,7,7,7,7,7,7,7,7,7,7,7,7,7,7,
6,6,6,6,6,6,6,4,4,4,4,4,4,4,4,4,4,4,4,4,4,4,4,4,4,4,4,4,4,4,4,4,4,4,4,4,4,4,4,4,4,4,4,2,2,1,1,1,1,1,1,1,2,2,2,2,2,2,2,2,2,2,2,3,3,2,2,2,2,5,5,2,2,5,5,5,5,5,5,5,5,5,7,7,7,7,7,7,7,7,7,7,7,7,7,7,7,7,7,7,
6,6,6,6,6,6,6,4,4,4,4,4,4,4,4,4,4,4,4,4,4,4,4,4,4,4,4,4,4,4,4,4,4,4,4,4,4,4,4,4,4,4,4,4,4,4,1,1,1,1,1,1,2,2,2,2,2,2,2,2,2,2,2,2,2,2,2,2,2,5,5,5,2,2,5,5,5,5,5,5,5,7,7,7,7,7,7,7,7,7,7,7,7,7,7,7,7,7,7,7,
6,6,6,6,6,6,6,4,4,4,4,4,4,4,4,4,4,4,4,4,4,4,4,4,4,4,4,4,4,4,4,4,4,4,4,4,4,4,4,4,4,4,4,4,4,4,4,4,1,1,1,1,2,2,2,2,2,2,2,2,2,2,2,2,2,2,2,2,2,2,5,5,1,5,2,5,5,5,5,5,5,5,5,7,7,7,7,7,7,7,7,7,7,7,7,7,7,7,7,7,
6,6,6,6,6,6,6,4,4,4,4,4,4,4,4,4,4,4,4,4,4,4,4,4,4,4,4,4,4,4,4,4,4,4,4,4,4,4,4,4,4,4,4,4,4,4,4,1,1,1,2,2,2,2,2,2,2,2,2,2,2,2,2,2,2,2,2,2,2,5,5,3,3,5,5,5,5,5,5,5,5,7,7,7,7,7,7,7,7,7,7,7,7,7,7,7,7,7,7,7,
6,6,6,6,6,6,6,4,4,4,4,4,4,4,4,4,4,4,4,4,4,4,4,4,4,4,4,4,4,4,4,4,4,4,4,4,4,4,4,4,4,4,4,4,4,4,4,4,4,1,1,2,2,2,3,3,2,2,2,2,2,2,2,2,2,2,2,2,2,2,2,3,3,3,1,5,5,5,5,5,5,7,7,7,7,7,7,7,7,5,7,7,7,7,7,7,7,7,7,7,
6,6,6,6,6,6,6,4,4,4,4,4,4,4,4,4,4,4,4,4,4,4,4,4,4,4,4,4,4,4,4,4,4,4,4,4,4,4,4,4,4,4,4,4,4,4,4,4,4,1,2,2,2,3,3,3,2,2,2,2,2,2,2,2,2,2,1,2,2,5,2,3,3,1,1,5,5,5,5,7,7,7,7,7,7,7,7,7,5,7,7,5,7,7,7,7,7,7,7,7,
6,6,6,6,6,6,4,4,4,4,4,4,4,4,4,4,4,4,4,4,4,4,4,4,4,4,4,4,4,4,4,4,4,4,4,4,4,4,4,4,4,4,4,4,4,4,4,4,4,4,4,2,2,2,3,3,2,2,2,2,2,2,2,2,1,2,1,1,5,5,5,5,5,1,5,5,5,5,5,5,7,7,7,7,7,7,7,7,7,5,5,7,5,7,7,7,7,7,7,7,
6,6,6,6,4,4,4,4,4,4,4,4,4,4,4,4,4,4,4,4,4,4,4,4,4,4,1,4,4,1,4,4,4,4,4,4,4,4,4,4,4,4,4,4,4,4,4,4,4,4,2,4,2,2,2,2,2,2,2,2,2,2,2,2,1,1,1,2,5,5,5,5,5,1,5,5,5,5,7,7,7,7,7,7,7,7,5,5,5,5,5,5,7,7,7,7,7,7,7,7,
6,6,6,6,6,4,4,4,4,4,4,4,4,4,4,4,4,4,4,4,4,4,4,4,4,4,1,1,1,1,4,4,4,4,4,4,4,4,4,4,4,4,4,4,4,4,4,4,4,4,4,4,4,2,2,2,2,2,2,2,2,2,1,1,1,1,1,5,5,5,5,5,5,1,5,5,5,5,5,7,7,7,7,7,7,7,7,7,5,5,5,5,5,5,5,7,7,7,7,7,
6,6,6,6,4,6,6,4,4,4,4,4,4,4,4,4,4,4,4,4,4,4,4,4,1,1,5,1,5,1,4,4,4,4,4,4,4,4,4,4,4,4,4,4,4,4,4,4,4,4,4,4,4,4,2,2,2,2,2,2,2,2,1,1,1,1,5,5,5,5,5,5,5,2,5,5,5,5,7,7,7,7,7,7,7,7,7,5,5,5,5,5,5,7,7,7,7,7,7,7,
6,6,6,6,6,4,6,6,6,4,4,4,4,4,4,4,4,4,4,4,4,4,4,1,1,1,1,5,5,1,1,1,4,4,4,4,4,4,4,4,4,4,4,4,4,4,4,4,4,4,4,4,4,4,4,2,2,2,2,2,2,2,1,1,1,1,2,2,2,5,5,5,5,2,5,5,7,7,7,7,7,7,7,7,7,7,7,7,5,5,5,5,5,5,7,7,7,7,7,7,
6,6,6,6,4,6,6,6,4,4,4,4,4,4,4,4,4,4,4,4,4,4,4,4,1,5,1,5,5,1,1,4,4,4,4,4,4,4,4,4,4,4,4,4,4,4,4,4,4,4,4,4,4,4,4,2,2,2,2,2,2,2,2,2,2,2,5,5,2,2,2,5,5,2,2,7,5,7,7,7,7,7,7,7,7,7,7,5,5,5,5,5,7,7,7,7,7,7,7,7,
6,6,6,6,4,4,6,4,4,4,4,4,4,4,4,4,4,4,4,4,4,4,4,4,4,1,5,5,5,1,1,4,4,4,4,4,4,4,4,4,4,4,4,4,4,4,4,4,4,4,4,4,4,4,4,2,2,2,2,2,2,2,2,2,2,5,5,5,5,5,5,2,1,2,5,5,5,7,7,7,7,7,7,7,7,7,7,7,5,7,7,7,5,7,7,7,7,7,7,7,
6,6,6,4,4,4,4,4,4,4,4,4,4,4,4,4,4,4,4,4,4,4,4,4,1,1,5,1,5,1,1,4,4,4,4,4,4,4,4,4,4,4,4,4,4,4,4,4,4,4,4,4,4,4,4,2,2,2,2,2,2,2,5,2,2,5,5,5,5,5,5,2,5,5,5,5,5,7,7,7,7,7,7,7,7,7,7,5,7,7,7,5,7,7,7,7,7,7,7,7,
6,6,6,6,4,4,6,4,4,4,4,4,4,4,4,4,4,4,4,4,4,4,4,4,4,4,1,1,1,1,4,4,4,4,4,4,4,4,4,4,4,4,4,4,4,4,4,4,4,4,4,4,4,4,4,4,2,2,2,2,2,5,5,1,3,3,1,5,5,5,5,5,2,5,5,5,5,7,7,7,7,7,7,7,7,7,7,7,7,7,7,7,7,7,7,7,7,7,7,7,
6,6,6,6,6,6,4,4,4,4,4,4,4,4,4,4,4,4,4,4,4,4,4,4,4,1,4,1,1,1,4,4,4,4,4,4,4,4,4,4,4,4,4,4,4,4,4,4,4,4,4,4,4,4,4,2,2,2,2,2,5,5,1,3,3,3,5,5,5,5,5,2,5,5,5,5,5,7,7,7,7,7,7,7,7,7,7,7,7,7,7,7,7,7,7,7,7,7,7,7,
6,6,6,6,6,6,4,4,4,4,4,4,4,4,4,4,4,4,4,4,4,4,4,4,4,4,4,4,4,4,4,4,4,4,4,4,4,4,4,4,4,4,4,4,4,4,4,4,4,4,4,4,4,4,4,4,4,2,2,2,5,5,5,5,3,3,5,5,5,5,5,5,5,5,5,5,5,7,7,7,7,7,7,7,7,7,7,7,7,7,7,7,7,7,7,7,7,7,7,7,
6,6,6,6,6,6,4,4,4,4,4,4,4,4,4,4,4,4,4,4,4,4,4,4,4,4,4,4,4,4,4,4,4,4,4,4,4,4,4,4,4,4,4,4,4,4,4,4,4,4,4,4,4,4,4,4,4,2,5,5,5,5,5,5,5,5,5,5,5,5,5,5,5,5,5,5,7,7,7,7,7,7,7,7,7,7,7,7,7,7,7,7,7,7,7,7,7,7,7,7,
6,6,6,6,6,4,4,4,4,4,4,4,4,4,4,4,4,4,4,4,4,4,4,4,4,4,4,4,4,4,4,4,4,4,4,4,4,4,4,4,4,4,4,4,4,4,4,4,4,4,4,4,4,4,4,4,4,4,5,5,5,5,5,5,5,5,5,5,5,5,5,5,5,5,5,5,7,7,7,7,7,7,7,7,7,7,7,7,7,7,7,7,7,7,7,7,7,7,7,7,
6,6,6,6,6,4,4,4,4,4,4,4,4,4,4,4,4,4,4,4,4,4,4,4,4,4,4,4,4,4,4,4,4,4,4,4,4,4,4,4,4,4,4,4,4,4,4,4,4,4,4,4,4,4,4,4,4,2,5,5,5,5,5,5,5,5,5,5,5,5,5,5,5,5,5,5,7,7,7,7,7,7,7,7,7,7,7,7,7,7,7,7,7,7,7,7,7,7,7,7,
6,6,6,6,6,4,4,4,4,4,4,4,4,4,4,4,4,4,4,4,4,4,4,4,4,4,4,4,4,4,4,4,4,4,4,4,4,4,4,4,4,4,4,4,4,4,4,4,4,4,4,4,4,4,4,4,4,4,5,5,5,5,5,5,5,5,5,5,5,5,5,5,5,5,5,5,5,7,7,7,7,7,7,7,7,7,7,7,7,7,7,7,7,7,7,7,7,7,7,7,
6,6,6,6,4,4,4,4,4,4,4,4,4,4,4,4,4,4,4,4,4,4,4,4,4,4,4,4,4,4,4,4,4,4,4,4,4,4,4,4,4,4,4,4,4,4,4,4,4,4,4,4,4,4,4,4,4,5,5,5,5,5,5,5,5,5,5,5,5,5,5,5,5,5,5,5,7,7,7,7,7,7,7,7,7,7,7,7,7,7,7,7,7,7,7,7,7,7,7,7,
6,6,6,6,4,4,4,4,4,4,4,4,4,4,4,4,4,4,4,4,4,4,4,4,4,4,4,4,4,4,4,4,4,4,4,4,4,4,4,4,4,4,4,4,4,4,4,4,4,4,4,4,4,4,4,4,4,5,5,5,5,5,5,5,5,5,5,5,5,5,5,5,5,5,5,5,7,7,7,7,7,7,7,7,7,7,7,7,7,7,7,7,7,7,7,7,7,7,7,7
]