4,4,4,4,4,4,4,4,4,4,4,4,4,4,
4,7,7,7,5,5,5,5,5,7,7,7,4,4,
4,7,2,1,1,5,5,5,5,1,2,2,7,4,
4,7,1,2,1,5,5,1,1,2,2,7,4,4,
4,7,1,2,1,1,1,1,5,1,2,2,7,4,